################
#.......#..#...#
#...G...#......#
#.......#......#
##......#.....##
#..............#
#..............#
#.......S......#
#..............#
#..............#
#..............#
#..............#
#..............#
#.............##
#.............##
################
