################
#..............#
#....G.........#
##.............#
##.....###....##
#..............#
#..............#
#..............#
###............#
##......#.....S#
#.......#......#
#..............#
#..............#
#.............##
#...........####
################
