################
#...........#..#
##.............#
#..............#
#..............#
#..............#
#......G.......#
#..............#
#..............#
#..............#
#....######....#
#....#......S..#
#..............#
#.............##
#....#.........#
################ 