################
#..............#
#..............#
#..............#
#..............#
#..............#
#..............#
#......G.......#
#..............#
#..............#
#..............#
#..............#
#..............#
#..............#
#S.............#
################
