################
#..............#
#..............#
#............G.#
#.....##.......#
#......#.......#
##.............#
##.............#
##.............#
#.......##.....#
#........#.....#
#.####.........#
#...#..........#
#........#....##
#S.......#.....#
################